#######################################
# @                                   #
##### ############################# ###
#                                     #
############ ##########################
#                                     #
#                                     #
############################### #######
#                                     #
###### ###### #########################
###### ######  ########################
######       # ########################
######       #      $ #################
#           #########                 #
####### ##################### #########
#        ############           #######
#    ##########################       #
#                                     #
#                                     #
#######################################